####################
#                  #
#      ###         #
#      #           #
#      ###         #
#                  #
####################
